abk	abk	Abkhazian
aar	aar	Afar
afr	afr	Afrikaans
aka	aka	Akan
sqi	alb	Albanian
amh	amh	Amharic
ara	ara	Arabic
arg	arg	Aragonese
hye	arm	Armenian
asm	asm	Assamese
ava	ava	Avaric
ave	ave	Avestan
aym	aym	Aymara
aze	aze	Azerbaijani
bam	bam	Bambara
bak	bak	Bashkir
eus	baq	Basque
bel	bel	Belarusian
ben	ben	Bengali
bih	bih	Bihari languages
bis	bis	Bislama
bos	bos	Bosnian
bre	bre	Breton
bul	bul	Bulgarian
mya	bur	Burmese
cat	cat	Catalan, Valencian
cha	cha	Chamorro
che	che	Chechen
nya	nya	Chichewa, Chewa, Nyanja
zho	chi	Chinese
chv	chv	Chuvash
cor	cor	Cornish
cos	cos	Corsican
cre	cre	Cree
hrv	hrv	Croatian
ces	cze	Czech
dan	dan	Danish
div	div	Divehi, Dhivehi, Maldivian
nld	dut	Dutch, Flemish
dzo	dzo	Dzongkha
eng	eng	English
epo	epo	Esperanto
est	est	Estonian
ewe	ewe	Ewe
fao	fao	Faroese
fij	fij	Fijian
fin	fin	Finnish
fra	fre	French
ful	ful	Fulah
glg	glg	Galician
kat	geo	Georgian
deu	ger	German
ell	gre	Greek, Modern (1453-)
grn	grn	Guarani
guj	guj	Gujarati
hat	hat	Haitian, Haitian Creole
hau	hau	Hausa
heb	heb	Hebrew
her	her	Herero
hin	hin	Hindi
hmo	hmo	Hiri Motu
hun	hun	Hungarian
ina	ina	Interlingua (International Auxiliary Language Association)
ind	ind	Indonesian
ile	ile	Interlingue, Occidental
gle	gle	Irish
ibo	ibo	Igbo
ipk	ipk	Inupiaq
ido	ido	Ido
isl	ice	Icelandic
ita	ita	Italian
iku	iku	Inuktitut
jpn	jpn	Japanese
jav	jav	Javanese
kal	kal	Kalaallisut, Greenlandic
kan	kan	Kannada
kau	kau	Kanuri
kas	kas	Kashmiri
kaz	kaz	Kazakh
khm	khm	Central Khmer
kik	kik	Kikuyu, Gikuyu
kin	kin	Kinyarwanda
kir	kir	Kirghiz, Kyrgyz
kom	kom	Komi
kon	kon	Kongo
kor	kor	Korean
kur	kur	Kurdish
kua	kua	Kuanyama, Kwanyama
lat	lat	Latin
ltz	ltz	Luxembourgish, Letzeburgesch
lug	lug	Ganda
lim	lim	Limburgan, Limburger, Limburgish
lin	lin	Lingala
lao	lao	Lao
lit	lit	Lithuanian
lub	lub	Luba-Katanga
lav	lav	Latvian
glv	glv	Manx
mkd	mac	Macedonian
mlg	mlg	Malagasy
msa	may	Malay
mal	mal	Malayalam
mlt	mlt	Maltese
mri	mao	Maori
mar	mar	Marathi
mah	mah	Marshallese
mon	mon	Mongolian
nau	nau	Nauru
nav	nav	Navajo, Navaho
nde	nde	North Ndebele
nep	nep	Nepali
ndo	ndo	Ndonga
nob	nob	Norwegian Bokmål
nno	nno	Norwegian Nynorsk
nor	nor	Norwegian
iii	iii	Sichuan Yi, Nuosu
nbl	nbl	South Ndebele
oci	oci	Occitan
oji	oji	Ojibwa
chu	chu	Church Slavic, Old Slavonic, Church Slavonic, Old Bulgarian, Old Church Slavonic
orm	orm	Oromo
ori	ori	Oriya
oss	oss	Ossetian, Ossetic
pan	pan	Punjabi, Panjabi
pli	pli	Pali
fas	per	Persian
pol	pol	Polish
pus	pus	Pashto, Pushto
por	por	Portuguese
que	que	Quechua
roh	roh	Romansh
run	run	Rundi
ron	rum	Romanian, Moldavian, Moldovan
rus	rus	Russian
san	san	Sanskrit
srd	srd	Sardinian
snd	snd	Sindhi
sme	sme	Northern Sami
smo	smo	Samoan
sag	sag	Sango
srp	srp	Serbian
gla	gla	Gaelic, Scottish Gaelic
sna	sna	Shona
sin	sin	Sinhala, Sinhalese
slk	slo	Slovak
slv	slv	Slovenian
som	som	Somali
sot	sot	Southern Sotho
spa	spa	Spanish, Castilian
sun	sun	Sundanese
swa	swa	Swahili
ssw	ssw	Swati
swe	swe	Swedish
tam	tam	Tamil
tel	tel	Telugu
tgk	tgk	Tajik
tha	tha	Thai
tir	tir	Tigrinya
bod	tib	Tibetan
tuk	tuk	Turkmen
tgl	tgl	Tagalog
tsn	tsn	Tswana
ton	ton	Tonga (Tonga Islands)
tur	tur	Turkish
tso	tso	Tsonga
tat	tat	Tatar
twi	twi	Twi
tah	tah	Tahitian
uig	uig	Uighur, Uyghur
ukr	ukr	Ukrainian
urd	urd	Urdu
uzb	uzb	Uzbek
ven	ven	Venda
vie	vie	Vietnamese
vol	vol	Volapük
wln	wln	Walloon
cym	wel	Welsh
wol	wol	Wolof
fry	fry	Western Frisian
xho	xho	Xhosa
yid	yid	Yiddish
yor	yor	Yoruba
zha	zha	Zhuang, Chuang
zul	zul	Zulu
